|-------------------------------------------------------------------------------------------------|
|                                                                                                 |
|                                                                                                 |
|      |--------                  ------                  ------                  --------|       |
|      |                                                                                  |       |
|      |                                                                                  |       |
|      |                                                                                  |       |
|      |                                                                                  |       |
|      |                                                                                  |       |
|                                                                                                 |
|                                                                                                 |
|      |                                                                                  |       |
|      |                                                                                  |       |
|      |                                                                                  |       |
|      |                                                                                  |       |
|                                                                                                 |
|                                                                                                 |
|      |                                                                                  |       |
|      |                                                                                  |       |
|      |                                                                                  |       |
|      |                                                                                  |       |
|      |                                                                                  |       |
|      |                                                                                  |       |
|      |                                                                                  |       |
|      |                                                                                  |       |
|      |                                                                                  |       |
|      |-------                    ------                   ------                --------|       |
|                                                                                                 |
|                                                                                                 |
|-------------------------------------------------------------------------------------------------|