|------------------------------------------------------------------------------------------------|
|                                                                                                |
|                                                                                                |
|      |--------                  ------                  ------                  --------|      |
|      |                                                                                  |      |
|      |                                                                                  |      |
|      |                                                                                  |      |
|      |                                                                                  |      |
|      |                                                                                  |      |
|                                                                                                |
|                                                                                                |
|      |                                                                                  |      |
|      |                                                                                  |      |
|      |                                                                                  |      |
|      |                                                                                  |      |
|                                                                                                |
|                                                                                                |
|      |                                                                                  |      |
|      |                                                                                  |      |
|      |                                                                                  |      |
|      |                                                                                  |      |
|      |                                                                                  |      |
|      |                                                                                  |      |
|                                                                                                |
|                                                                                                |
|      |                                                                                  |      |
|      |                                                                                  |      |
|      |                                                                                  |      |
|      |                                                                                  |      |
|      |                                                                                  |      |
|      |--------                  ------                  ------                  --------|      |
|                                                                                                |
|                                                                                                |
|------------------------------------------------------------------------------------------------|